The sound files have been given names using an ASCII transcription of the IPA (some operating systems poorly handle filenames containing Unicode characters). The correspondences are the following:

A	ɤ
C	ɕ
dzx	dʐ
G	ɣ
ʰ	h
J	ɟ
N	ŋ
NG	ɴɢ
R	ʁ
sx	ʂ
tsx	tʂ
Y	ɲ
W	ɯ
Z	ʑ

A few sound files are missing due to external noise during recording (17 clusters out of 411, indicated by XXX in the list below). These files will be re-recorded during my next field trip.
The verbs are normally in the third person singular factual (the only non-prefixed form in the verb system), but in some iterations the speakers give the infinitive (prefixed with kɯ- or kɤ-) or the evidential form (with to-, pjɤ-, lo-, cʰɤ-, ko-, ɲɤ- or jo- depending on the verb) instead.

ɯ-pɯ	p	
ɯ-pʰɯ	ph	
babɯ	b	
mbɯt	mb	
mɯɴɢɯ	NG2		
wɯwɯ	w	
tɯ-boʁ	t	
tʰɯ-ɣi	th	
dɯdɯt	d	
ndɯ	nd 	
ts tɤ-tsoʁ
tsʰɯtʰo	tsh 	
dzɯrdzɯr	dz 	
ndzɯpe	ndz 	
nɯŋa	n 	
sɯmat	s 	
zɯmi	z 	
lɯlu	l 	
ɬɯɣnɤɬɯɣ	lh 	
tʂɯmpa	tsx 	
tʂʰɯɣ	tsxh
dʐɯɣdʐɯɣ	dzx
ndʐɯnbu	ndzx	
ʂɯŋʂɯŋ	sx	
rɯ	r 	
ɯ-tɕɯ	tC 	
tɕʰɯwur	tCh	
dʑɯβdʑɯβ	dz2
ndʑɯnɯ	ndz2	
ɕɯŋgɯ	C	
ʑɯrɯʑɤri	z2
cɯ	c2
tɤ-cʰɯ	ch	
waɟɯ	J2
ɲɟɯ	YJ
ɲɯɣɲɯɣ	Y 	
ɯ-jɯ	j 	
kɯki	k 	
kʰɯna	kh	
gɯgɯɣ	g 	
ɯ-ŋgɯ	Ng	
ɕaŋɯ	C
xɯrxɯr	x 	
ɣɯ	ɯ 	g2	
qɯqli	q 	
kɯ-sɤqʰɯqʰa	qh	
mɯɴɢɯ	NG2		
χaŋχaŋ X2 
naŋʁɯ	R2
==============
ɯ-wtaʁ	wt 	
wdɯt	wd 	
wtsoʁ	wts 	
wtsʰi  XXXX
wsaŋ	ws 	
wzaŋsa	wz 	
wtɕar	wtC 	
wtɕʰur	wtCh	
wɕaʁ	XXXX
wʑar	wz2	
wtʂi	wtsx
tɯwcaʁ	wc 	
wɟi	wJ 	
wka	wk 	
wgoz	wg 	
spoz	sp 	
smar	sm 	
staχpɯ	st 	
stʰaβ	sth	
sna	sn 	
scoʁ	sc 	
scʰɤt	sch	
sɲaŋne	sY
skɤm	sk 	
rɟɤskʰi	skh
sŋaʁ	sN2
sqamnɯz	sq 	
sqʰi	sqh 	
zbaʁ	zb 	
tɤzmbɯr	zmb	
zmɤrɤw	zm 	
zdɯm	zd 	
znde	znd 	
znɤje	zn 	
kɯ-nɯzɟɯ	zJ 	
zɲɟa	zYJ 	
zga	zg 
kɤ-ɤkhɤzŋga	zNg	
wxti	wxt 	
wstɯn	wst 	
wrtɤn	wrt 	
wskɤr	wsk 	
wzgɤr	XXX
wzdɯ-nɯ	wzd 	
wzɟɯr	wzJ
wrɟaŋ	wrJ
tɯ-lpɤɣ	lp 	
tɤ-lmɯz	lm 	
ltɤw	lt	
ldɯɣi 	ld 	
lni 	ln 	
ɕɤltsaʁ	lts 	
ltsʰɤltsʰɤt	ltsh 	
ʂtɤltɕaʁ	ltC 	
ltɕʰɤltɕʰɤt	ltCh	
ldʑaŋkɯ	ldZ2 	
ldʐaŋldʐaŋ	ldzx 	
lcɯɣlcɯɣ	lc 	
tɯ-lcʰɯɣ	lch 
lŋɤlŋɤt	lN2 	
lxɤwlxɤw	lx 	
lqɤnɤlqɤt lq
to-qalpɕa	lpC 	
armbat	rmb 	
rmɤwja	rm 	
rdɤstaʁ	rd 	
rnde 	rnd 	
rnaʁ	rn 	
rdzardza	rdz 	
rndzɤkɤŋe	rndz	
tɯ-rzɯɣ 	rz 	
cɯrndʑi	rndZ2
tɤ-rʑaβ	rZ2 	
rɟaʁ	rJ 	
rɲɟaʁlo	rYJ 	
rɲaŋ	rY 	
rga	rg 	
rŋgɤm	rNg 	
tɯ-rŋa	rN2 	
ɕɯrɴɢo	rNG2 	
tɯ-ʂpa	rp 	
ʂpʰɤwrpʰɤw	rph &
ʂtalu	rt 	&
ɯ-pɤʂtʰɤβ	rth	&
ʂtsot	rts 	
ʂtshom	rtsh 	
ʂɕɯwʂɕɯw	rC	
ʂsɯwʂsɯw	rs 	&
nɯʂtɕe	rtC	&
ʂtɕʰɯʁjɯ	rtCh	
tɤ-ʂcoʁ	rc3
ɯ-ʂcʰaʂcʰɤw	rch
ʂɲoʁʂɲoʁ	sxY 	
ʂko	rk	
tɤ-ʂkʰom	rkh 	
ʂqoʁ	rq 	
tɤ-ʂqʰu	rqh 	
ʂχɯʂχi	sxX 	
jpum	jp 	
jmɯt	jm 	
ajtɯ	jt 	
jnom 	jn 	
tɤ-jtsi	jts 
jtshi	jtsh 	&
qɤjtʂʰa	jtsxh 	&
jndʐɤz	jndzx
tɤ-jkɯz	jk	
tɤ-jŋoʁ	jN2	
jqe	jq 	
ajχoʁ	jX	&
tɯ-jmŋo	jmN	&
ɕpaʁ	Cp
ɕpʰɤt	Cph	&
ʑmbɤr	Zmb2	
ɕmi 	Cmi	
ɕte	Ct 	
ɕtʰɯz	Cth	
ʑdɯɣʑdɯɣ	Zd2	
ɕnat	Cn 	
ɕtʂaŋlaŋ	Ctsx	
ɕkom	Ck 	
ɕkʰo-nɯ	Ckh	
ʑgaʁ	Zg2	
ʑŋgu	ZNg2	
ɕŋaʁɕŋaʁ	CN2	
ɕqɤjɤr	Cq 	
ɕqʰaloʁ	Cqh	
ʑɴɢɯloʁ	ZNG3 	
tɯ-xpa	xp 	
tɯ-ɣmba	Gmb 	
tɯ-ɣmaz	Gm 	
xtɯt	xt 	
xtʰom	xth 	
ɣdɤso	Gd	
ɣnde	Gnd 	
ɣnɤsqi	Gn 	
xtsɤɕna	xts 	
xtsʰɯm	xtsh 	
xsar	xs 	
ɣzɯ	Gz 	
xtɕi	xtC	
xtɕʰɯt	xtCh	
ɣndʑɤw	GndZ	
xɕɤj	xC	
ɣʑo	GZ2	
nɤxtʂi	xtsx	
xʂɤxʂɤt	xsx 	
xcat	xc2	
tɤlɤxcʰi	xch	
ɣɟaw	GJ	
ɯ-ɣɲaʁ	GY	
χpi	Xp2	
taχpʰe	Xph	&	
χtɤrma	Xt
naχtʰɤw	Xth2	
χtso	Xts2	
χtsʰɤχtsʰɤt	Xtsh2	&
χsɤr	Xs2	
χtɕoŋ	XtC2	
χɕu	XC3	
χtʂɯɣdʑa	Xtsx2
χʂɤχʂɤt	Xsx2
χcoŋkroŋ	Xc4
χcʰa	Xch2
χɲɤχɲɤr	XY
ʁbɤʁbɤβ	XXX
aʁmbɯm	Rmb2
ʁmaʁ	Rm2	
ʁdɯɣ	Rd2
ʁndɤr	Rnd2	
ʁnaʁna	Rn3
ʁndzɤr	Rndz3
ʁzɤw	Rz3
ʁʑɯnɯ	RZ4
ʁɟa	RJ2	
ʁɲɟiʁɲɟi	RYJ2	
ʁɲɤrpa	RY2
mpɯ	mp	
mpʰɯl	mph	&
ntaw	nt	
ntsɯ	nts	
ntsʰɤr	ntsh	&	
ntɕʰoz	ntCh	
ntʂu-nɯ	ntsx	
ɲcɤr	Yc	
ɲcʰoʁ	Ych	
ŋke	XXX
ŋkʰor	XXX
ɴqa	Nq	
ɴqʰi	Nqh	
mpɕɤr	mpC
anbaʁ	nb	
ngɯt	ng	
nŋo-nɯ	nN	
tɤ-mtɯ	mt	
mtʰɯ	mth	
mda	md	
mna	mn	
tɤ-mtsɯ	mts	
mtsʰɤm	mtsh	&
mdzadi	mdz	
mtɕoʁ	mtC	
tɤ-mtɕʰo	mtCh	
tɯ-mdʑu	mdZ2	
kɯ-ɤrɤmtʂɯmtʂɤj	mtsx	
mdʐɯɕɯɣ	mdzx	
tɤ-mcar	mc	
tɯ-mcʰi	mch	
tɯ-mɟa	mJ	
mɲɤm	mY	
tɯ-mke	mk	
mkʰɤz	mkh	
tɯ-mga	mg	
mŋɤm	mN2	
tɤ-mɢom	mG2	
dwaŋdwaŋ	dw	
zwɤr	zw	
lwɤz	lw	
rwa	rw	
aɣɯʂwaŋ	sxw	
jwajwa	jw	
kwitsɯt	kw	
xwɤrnɤxwɤr	xw3
χwɤr	Xw	
pjalu	pj	
bjɯɣbjɯɣ	bj 	
mbjom	mbj 	
tɕʰɯwja	wj	
djoʁdjoʁ	dj 	
ndjɤndjɤt	ndj 
tsjaŋnɤtsjaŋ	tsj 	
ndzjaʁ	ndzj	
sjaŋnɤsjaŋ	sj 	
zjaŋzjaŋ	XXX
qaljaʁ	lj 	
tɯ-rju	rj
pa-kjo 	kj 
kʰjɤt	XXXX	
ŋgjo	ŋgj	
tɯ-ɣjɤn	Gj
qjaw	qj 	
qʰjiqʰji	qhj 	
ɴɢja	NGj2	
ʁjit	Rj3
tɤ-wsjit	wsj 	
wzjoz	wzj 	
spjaŋkɯ	spj 	
spʰjar	sphj	
sqʰjar	sqhj	
ltʰjɤltʰjɤt	lthj	
lbjɯlbjɯɣ	lbj 	
ʂpjɯ	rpj	
tɤ-rmbja	rmbj 	
ʂtsjaʁ	rtsj 	
ɯ-ʂqʰjoʁ	rqhj 	
arɤrɴɢjoʁ	rNGj 	
χtsjɯ	Xtsj 	
χpjɤt	Xpj	
ɯ-χsjɯw	Xsj	
ɯ-mtsjoʁ	mtsj 	
mpja	mpj	
stjaŋnɤstjaŋ	stj
plɯt	pl
mblɯt	mbl
wli	wl 	
tslɯɣtslɯɣ	tsl 	
sloʁ	sl 	
tɯ-zloʁ	zl 	
ɕlu	Cl	
rlaʁ	rl 	
claŋclaŋ	cl2
jla	jl 	
klɯɣklɯɣ	kl 	
glɤɣglɤɣ gl	
cɯŋglɯɣ	Ngl	
ɣle	Gl2	
qlɯt	ql	
qhlɯ	qhl	
ʁɴɢlɯt	NGl2	
tɯ-ʁla	Rl2 
sclaŋsclaŋ scl 
sqlɯm	sql	
asqʰlu	sqhl	
ɕploʁɕploʁ	Cpl
ɕkli	XXX 
ɕqlɯwnɤqlɯw	Cql	
ɕqʰlɤt	Cqhl	
arɴɢlɯm	RNGl	
χploʁχploʁ	Xpl	
ʁɲɟliʁɲɟli	RYJl
mqlaʁ	mql	
tɯ-mɢla	mGl	
pri	pr 	
kʰɤpʰrɯ	phr	&
brɯzbrɯz	br	
mbrɤt	mbr	
wraʁ	Br2	
droŋdroŋ	dr	
qomdroŋ	ndr	
tsri	tsr	
ndzri	ndzr	
ɯ-srɯw	sr	&	
zrɯ	zr	
tɕrɯɣnɤtɕrɯɣ	tCG	
ɕri	Cr	&
ʑru	XXX
crɯɣcrɯɣ	cr2	
chrɤwchrɤw	chr	&
ɟrɯɣɟrɯɣ	Jr	
ɯ-jroʁ	jr2	
krɤɣ	kr	
khro	khr	
grɯwgrɯw	gr	
ŋgrɤl	Ngr	
ɣro	Gr2	
qro	qr	
ɴɢraʁ	NGr2
ʁrɯlu	Rr	
wkrɯz	wkr	
wɣrum	wGr	
wsroŋ	wsr	
sprɯskɯ	spr
zbrilu	zbr	
sɤzmbri	zmbr
stʰrɯw	sthr
scraʁscraʁ	scr	
zɟraŋzɟraŋ	zJr	
skraskra	skr
tɯ-skʰrɯ	skhr	
zgrawa	zgr	
sɤsqra	sqr	
aɕprɯm	Cpr	
ʑmbri	Zmbr2	
ɕtraŋɕtraŋ	Ctr
ʑdraŋʑdraŋ	Zdr	
ɕkrɤz	Ckr	
ʑgrɯ	XXXXX
ʑŋgri	ZNgr	
ɕqraʁ	Cqr	
jkrɯt	jkr	
jtsraw	jtsr	
ta-ɣɤxpra	xpr	
tɕʰɯχpri	Xpr2
taʁmbra	Rmbr	
ɣɤχsrɯ	XXX
aʁzrɤwɤlu	XXX
χcɯχcri	Xcr
ʁɟɯʁɟri	RJr	
ʁgra	Rgr	
ɲcɯɲcri	Ycr	
ŋkʰrɯli	Nkhr	
ɯ-ɴqra	Nqr
mɯmtsrɯɣ	mtsr	
mpʰrɯmɯ	mphr	
mkʰroŋ	mkhr	
mgrɯn	mgr	
nbraʁ	nbr	
pɣa	pG	
pʰɣo	phG	
mbɣaʁ	mbG	
wɣa	wG	
tɯ-tɣa	tG	
tʰɣe	thG	
dɣɤrdɣɤr	dG	
ndɣɤndɣɤt	ndG	
tsɣi	tsG	
tɯ-ndzɣi	ndzG	
sɣa	sG	
zɣa	zG2	
lɣe	lG
tɕɣaʁ	tCG	
tɕʰɣaʁtɕʰɣaʁ	tChG
ndʑɣaʁ	ndZG2
tɯ-ɕɣa	CG
tɯ-rɣi	rG3
ʑɣɤpa	ZG3	
ʂɣɤlʂɣɤl	sxG
qacʰɣa	chG	
ɲɟɤrɲɟɤr	YJG	
jɣɤt	XXXX
spɣi	spG	
tɤkɤzbɣaʁ	zbG	
stɣɤrnɤstɣɤr		stG
lcʰɣaʁlcʰɣaʁ	lchG	
stoʁldzɣɤm	ldzG	
ɕpɣo	CpG	
ɕpʰɣo-nɯ	CphG
nɤjmbɣom	jmbG
jpɣom	jpG	
tɤ-rmbɣo	rmbG	
ʂpɣo	rpG	
ʁmbɣi	RmbG2	
mpʰɣaʁmpʰɣaʁ	XXX
ntɕʰɣaʁ	XXXX
antʰɣar	nthG	
ntsɣe	XXX
nɤntsʰɣɤz ntshG	
ɲcɣɤɲcɣɤt YcG
ɲcʰɣaʁ	YchG
wʁa	wR2
tɯ-ndzʁi	ndzR2	
zʁɤɲcɯ	zR2
lʁa	lR
tɕʁɯznɤtɕʁɯz	tCR2	
tɕhʁɯznɤtɕhʁɯz	tChR2
rʁe	rR2
ajʁu	jR3